###################
#      #       // #
#   X  #      //  #
#      #     //   #
#      #    //    #
#   ####   //     #
#       ////      #
#      //   #######
#   #  //   #     #
#      //   #  @  #
#      //         #
###################